만나소 반가워요 - senang bertemu dengan mu 
안녕하세요 - halo
잘지냈어요 - apa kabar
감사합니다 - terima kasih 
죄송합니다 - maaf
지루합니다 - membosanakan
요리하다 - memasak
었습니다 - positif
없습니다 - negatif
메시지 - pesan
아니요 - tidak
선생님 - guru
의미 - berarti
사과 - apel
저는 - saya
진짜 - beneran
대박 - bagus
설바 - masa sih
사람 - orang
영화 - film
핛생 - murid
학고 - sekolah
남자 - pria
여자 - wanita
친구 - teman
음식 - makanan
가수 - penyanyi
헐 - yah
차 - teh
와 - wow
맛 - rasa
네 - ya
예 - iya
빵 - roti
책 - buku
집 - rumah
산 - gunung 
낮 - siang 
밤 - malam